NO ./assets/wall_north.xpm
SO ./assets/wall_south.xpm
WE ./assets/wall_west.xpm
EA ./assets/wall_east.xpm
F 29,247,247
C 1,221,45
        1111111111111111111111111
        1000000000110000000000001
        1011000001110000000000001
        1001000000020000000000001
111111111011000001110000000000001
100000000011000001112111121111111
11112111111111011100000010001
11110111111111011101010010001
11000000110101011100000010001
10E00000000000001100000010001
10000000000000001101010010001
1100000111010101111101111000111
11110111 1110101 101111010001
11111111 1111111 111111111111