NO ./assets/wall_north
SO ./assets/wall_south
WE ./assets/wall_west
EA ./assets/wall_east
F 29,247,247
C 1,221,45
1111
100111
1000W1
100111
1111
