NO ./assets/wall_north
SO ./assets/wall_south
WE ./assets/wall_west
EA ./assets/wall_east
F 120,50,0
C 125,15,0
1111
100111
1000W1
100111
1111
