EA ./assets/Weave_07.xpm
F 29,247,247

SO ./assets/wall_south.xpm



C 1,221,45




WE ./assets/wall_west.xpm






NO ./assets/wall_north.xpm



1111 
1001110
1002W1
100111 1
1111
1