NO ./assets/wall_north.xpm
SO ./assets/wall_south.xpm
WE ./assets/wall_west.xpm
EA ./assets/wall_east.xpm
F 10,30,60
C 220,180,120
1111111
1     1
1 111 1
1 1S1 1
1 111 1
1     1
1111111
